MMMMMMMMMMMMMMML
M.............ML
M..MMMMMMMMM..ML
MP.GBM   MBG..ML
MMMMMM   MMM..ML
         MMM..ML
MMMM     MG...ML
M..MMMMMMMMM..ML
ME..GMBM.M.M..ML
M..........B..ML
MMMMMM..MMMM..ML
     MMMM  M..ML
           MMMML
C